NO      ./textures/exit.xpm
SO 			./textures/grass.xpm
WE ./textures/player.xpm

EA ./textures/pokeball.xpm





F 8, 74, 26
C 10, 108, 199
        1111111111111111111111111
        1000000000110000000000001
        1011000001110000000000001
        1001000000000000000000001
111111111011000001110N00000000001
100000000011000001110111111111111
10000111111111011100000000001
11110111111111011101010010001
11000000110101011100000010001
10000000000000001100000010001
10000000000000001101010010001
1100000111010101111101111000111
11110111 1110101 100000000001
11111111 1111111 111111111111
