NO      ./textures/exit.xpm
SO 			./textures/grass.xpm
WE ./textures/player.xpm

EA ./textures/pokeball.xpm





F 8, 74, 26
C 10, 108, 200
   11111
   1N1
   11111