NO      ./textures/exit.xpm
SO 			./textures/grass.xpm
WE ./textures/player.xpm

EA ./textures/pokeball.xpm





F 8, 74, 26
C 0, 151, 151
   11111
   1E1
   11111