NO      ./textures/mossy.xpm
SO 			./textures/redbrick.xpm
WE ./textures/wood.xpm

EA ./textures/greystone.xpm





F 0, 0, 0
C 0, 0, 0
        1111111111111111111111111
        1000000000110000000000011
        10110000011100000N0000001
        1001000000000000000000001
111111111011000001110000000000001
100000000011000001110111111111111
10000111111111011100000000001
11110111111111011101010010001
11000000110101011100000010001
10000000000000001100000010001
10000000000000001101010010001
1100000111010101111101111000111
11110111 1110101 100000000001
11111111 1111111 111111111111